###########################
#                        .#
#   ##   ###   ###   ###  #
#    ##### ##### ##### #####
#                          #
#                          #
# #### ##### ###### #####  #
###  ###   ###    ###   #  #
#@    $                    #
#                          #
############################