###########################
#                       $.#
#  ###   ###   ###   ###  #
#  # ##### ##### ##### ####
#                         #
# #### ##### ###### ##### #
###  ###   ###    ###   # #
#@                        #
###########################