     #######     
   ###     ###
####  .      ##########
#   $   #            .#
#   #  #    #   #######
#   #           #
#       ##    #$#
####            #
####     #   ####
   ### @   ###
     #######
