      ###
   ####.###
####.     ######
#@           $ #
####### # #    #
# $  $  #.######
#       ###
#########
