              ####  
###############  #
#           $    #
#   $@######     #
#  ####    #.   .#
####       #######