#############
#.         @#
########   ##
#      $    #
##          #
#############