#########
#      .#
#       #
#  $    #
#       #
#   @   #
#       #
#########