#########
#.     .#
#       #
#       #
#  $   $#
#       #
#@      #
#########