          ######
###########   .#
#             ##
#  $         #
#  @         #
##############