######
#   .#
# $  #
#@   #
######