   #####
####   #
#  $ $ ##
# $ $#  #
# $$ #$ #
#  # $  #
#  # #  #
##@ .#..#
 ##.....#
  #######