########
#      ####
#  #      #
# ###     #
#  $  ###.##
# $#$  # ..#
#  $      +#
#      #####
########