############
#          #
#     $    #
# *.*$*$*. #
#  * *.* * #
#          #
#     @    #
############