     ######
   ####   #
   #  #   #
 ###  $   #
 #.. $ $  #
 #.. ###$##
 #..  $   #
### ##  $ #
#   ## # @#
# ###  ####
#     ##
#######