    ####
    #  #
    #  #
    #@ #
  ###$.#
  #  $.#
  # #$.#
  #  $.#
### #$.#
#    $.#
# # #$.#
#   #  #
########